111111111111111111111111111111111111111111
100000010010000000000000000010010000000001
100000000000000000600000000000000000000001
100000000000000000600000000000000000000000
100000010010000000000000000010010000000001
111111110011111111111111111110011111111111
100000010010000000000000000006610000000001
100000000000000000000000000006600000000001
100000000000000000005000000006600000000001
100000010010000000000000000010010000000001
111111110011111111111111111110011111111111
100000010010000000000000000010010000000001
100000000000000000000000000000000000000001
000000000000000000000700000000000000000001
100000010010000000000000000010010000000001
111111111111111111111111111111111111111111
